+---+---+---+---+---+---+---+---+---+---+---+---+---+---+---+---+---+---+---+---+
G               |           |       |       |                               |   |
+   +---+---+   +   +---+   +   +   +   +   +   +---+   +---+---+---+---+   +   +
|           |   |   |   |   |   |   |   |       |       |   |       |       |   |
+---+---+   +---+   +   +   +   +   +---+   +---+   +---+   +   +   +   +---+   +
|           |       |       |   |               |       |       |   |           |
+   +---+---+   +---+---+   +   +---+---+---+---+---+   +---+---+   +   +---+---+
|       |       |       |   |   |   |                       |   |               |
+---+   +   +---+   +   +   +   +   +   +---+---+---+---+   +   +---+---+---+   +
|   |   |   |       |   |   |   |       |           |       |   |       |       |
+   +   +   +   +---+   +---+   +---+---+---+   +---+   +---+   +   +   +---+---+
|   |           |   |       |       |           |           |   |   |           |
+   +---+   +---+   +---+   +---+   +   +---+---+   +   +   +   +   +---+---+   +
|           |           |       |   |               |   |       |   |           |
+   +---+---+   +---+   +---+   +   +---+---+---+---+   +---+---+   +---+   +---+
|           |   |       |       |   |           |       |               |       |
+---+---+   +---+   +---+   +   +   +   +---+   +   +---+---+---+---+   +   +   +
|       |               |   |       |       |   |   |               |   |   |   |
+   +   +---+---+---+   +   +---+---+---+   +---+   +   +   +---+   +   +   +   +
|   |                   |   |           |       |   |   |   |   |   |   |   |   |
+   +---+---+---+---+---+   +   +---+   +---+   +   +   +   +   +   +   +   +   +
|       |           |       |       |   |       |       |       |   |   |   |   |
+---+   +   +---+   +---+   +---+---+   +   +---+---+---+---+---+   +   +   +   +
|       |   |           |           |   |                           |   |   |   |
+   +---+   +   +---+   +---+---+   +   +   +---+---+---+---+---+   +---+   +   +
|   |       |   |       |       |   |   |           |           |           |   |
+   +   +---+   +   +---+   +   +   +   +   +---+---+   +---+---+---+---+---+   +
|       |       |       |   |   |       |   |       |                           |
+---+---+   +---+---+   +   +   +---+---+   +   +   +---+---+---+---+   +   +---+
|       |       |           |   |       |       |   |           |       |   |   |
+   +   +---+   +---+---+---+   +---+   +---+---+   +---+   +   +   +---+   +   +
|   |   |   |       |       |   |       |   |               |   |       |       |
+   +   +   +---+   +   +---+   +   +---+   +   +---+---+---+---+---+   +---+---+
|   |       |       |           |           |       |                   |       |
+   +---+---+   +---+---+---+---+---+---+   +---+   +---+   +---+   +---+   +   +
|           |   |           |       |   |           |       |           |   |   |
+---+   +---+   +   +---+   +   +   +   +---+---+---+   +---+   +---+---+   +   +
|               |   |       |   |   |   |           |   |       |       |   |   |
+   +---+---+---+   +   +---+   +   +   +   +---+   +   +   +---+   +   +   +   +
|                   |           |       |       |       |           |       |   O
+---+---+---+---+---+---+---+---+---+---+---+---+---+---+---+---+---+---+---+---+