+---+---+---+---+---+---+---+---+---+---+
G           |               |           |
+   +---+   +---+   +---+   +   +---+---+
|   |   |           |           |       |
+   +   +---+---+---+   +---+---+   +   +
|       |       |       |           |   |
+---+---+   +---+   +---+   +---+---+   +
|       |           |       |       |   |
+   +   +---+---+   +   +---+   +---+   +
|   |           |       |       |       |
+   +---+---+   +---+---+   +---+   +---+
|   |       |       |       |       |   |
+   +   +   +---+   +   +---+   +---+   +
|   |   |   |   |               |       |
+   +   +   +   +---+   +---+---+   +---+
|   |   |   |   |   |       |       |   |
+   +   +   +   +   +---+   +   +   +   +
|   |   |   |   |               |   |   |
+   +---+   +   +---+   +   +---+   +   +
|           |           |       |       O
+---+---+---+---+---+---+---+---+---+---+