+---+---+---+---+---+---+---+---+---+---+---+---+---+---+---+---+---+---+---+---+---+---+---+---+---+---+---+---+---+---+
G           |           |           |               |               |           |                           |   |       |
+---+---+   +   +   +   +   +---+   +   +---+---+   +   +---+---+   +   +---+   +   +---+---+---+---+---+   +   +   +   +
|           |   |   |   |       |   |           |       |       |       |       |   |                   |   |   |   |   |
+   +---+---+---+   +---+---+---+   +---+---+   +---+---+   +   +---+---+   +---+   +   +---+---+   +---+   +   +   +   +
|   |       |       |           |       |   |           |   |   |       |   |       |   |       |           |   |   |   |
+   +   +   +   +---+   +---+   +---+   +   +---+   +   +   +---+   +   +   +   +---+   +---+   +---+---+---+   +   +   +
|   |   |       |       |           |       |       |       |       |       |   |               |           |       |   |
+   +   +---+---+   +---+   +---+---+---+   +   +---+---+---+   +---+---+---+   +---+---+   +---+---+---+   +---+---+   +
|   |       |           |   |           |   |   |               |       |       |           |       |   |           |   |
+   +---+   +---+---+   +   +   +---+   +   +---+   +---+---+---+   +   +   +---+   +---+---+   +   +   +---+   +---+   +
|       |       |   |   |       |       |       |   |       |   |   |       |       |       |   |       |       |       |
+---+   +---+   +   +   +---+---+---+---+---+   +   +   +   +   +   +---+---+---+   +---+   +   +---+   +   +---+   +   +
|           |   |   |               |           |       |   |   |   |               |           |           |       |   |
+   +---+---+   +   +---+   +---+   +   +---+---+---+   +   +   +   +---+---+---+---+   +   +---+---+   +   +   +---+   +
|   |       |   |           |   |   |           |       |           |       |           |   |       |   |   |   |       |
+   +   +   +   +---+---+---+   +   +---+---+   +---+---+---+   +---+   +   +   +---+---+---+   +   +   +   +   +---+---+
|   |   |   |               |           |                   |   |       |   |   |       |       |   |   |   |           |
+   +---+   +---+---+---+   +---+---+   +   +---+---+---+   +   +   +---+   +   +   +---+   +---+   +   +   +---+   +   +
|           |           |   |           |           |       |   |   |   |   |   |   |       |           |           |   |
+---+   +---+   +---+   +   +   +---+---+---+---+---+   +---+   +   +   +   +   +   +   +---+---+---+---+---+---+---+   +
|   |               |   |   |   |           |       |           |   |   |       |       |           |       |           |
+   +---+---+   +   +   +   +   +   +---+   +   +   +   +   +---+   +   +---+---+---+   +   +---+   +   +   +   +---+---+
|           |   |   |   |       |       |       |   |   |   |       |               |   |       |   |   |   |   |       |
+---+---+   +   +   +---+   +---+---+   +---+---+   +   +   +   +---+---+---+---+   +   +---+   +   +   +   +   +   +   +
|               |   |       |                   |   |   |   |   |       |       |               |   |   |       |   |   |
+   +---+   +---+---+   +---+   +   +---+---+---+   +   +   +   +   +---+   +   +---+   +---+---+   +   +---+---+   +   +
|       |           |           |   |               |   |       |   |       |       |   |       |   |               |   |
+---+   +---+---+   +---+---+---+   +   +---+---+---+   +---+---+   +   +---+---+   +   +   +---+   +---+---+---+---+   +
|               |                   |                               |           |       |           |                   O
+---+---+---+---+---+---+---+---+---+---+---+---+---+---+---+---+---+---+---+---+---+---+---+---+---+---+---+---+---+---+