+---+---+---+---+---+---+---+---+---+---+---+---+---+---+---+---+---+---+---+---+---+---+---+---+---+
G   |           |           |       |       |                   |       |           |       |       |
+   +   +---+   +---+   +   +---+   +   +   +   +---+   +   +   +   +   +   +---+   +---+   +   +   +
|   |       |   |       |   |       |   |   |   |       |   |       |   |       |           |   |   |
+   +---+   +   +   +---+   +   +---+   +   +   +   +---+   +   +---+   +---+---+   +---+---+   +   +
|           |       |               |   |   |   |   |       |       |           |   |           |   |
+---+---+---+---+---+---+   +   +   +   +   +   +   +   +---+---+---+---+---+   +   +   +---+---+---+
|               |           |   |       |       |   |   |       |           |       |               |
+   +---+---+   +   +---+---+   +---+---+---+---+   +   +---+   +   +---+---+   +---+---+---+   +   +
|   |       |   |           |       |           |   |           |           |   |       |       |   |
+   +   +   +---+---+---+   +---+   +   +---+   +   +   +---+---+   +---+   +   +---+   +---+---+   +
|   |   |                   |       |       |   |   |   |           |   |       |                   |
+   +   +---+---+---+   +---+---+---+---+---+   +   +   +   +---+---+   +---+---+   +   +---+---+   +
|           |           |   |           |       |   |   |           |               |   |       |   |
+---+---+---+   +   +---+   +   +---+   +   +---+---+   +---+---+   +---+---+---+---+   +   +   +   +
|               |   |       |   |       |               |           |       |           |   |       |
+   +---+---+---+   +   +---+   +   +   +---+---+---+   +   +---+---+---+   +   +---+---+   +---+   +
|               |   |       |   |   |   |   |       |   |   |               |   |           |       |
+---+---+   +   +---+---+   +   +---+   +   +   +   +---+   +   +   +---+---+   +   +---+---+   +---+
|           |   |       |   |       |   |   |   |       |       |           |   |   |       |       |
+---+---+---+   +   +   +   +---+   +   +   +   +---+   +---+---+---+   +---+   +   +   +   +---+   +
|               |   |               |   |   |       |   |           |   |       |       |   |   |   |
+   +---+---+   +   +---+---+---+---+   +   +---+   +   +---+   +---+   +   +---+---+---+   +   +   +
|       |       |       |               |       |   |       |   |       |   |               |       |
+---+   +---+---+---+---+   +   +---+---+   +   +---+---+   +   +   +---+   +   +---+---+---+---+---+
|       |       |           |   |       |   |               |       |       |   |                   |
+   +---+   +   +   +---+---+   +   +   +   +   +---+---+---+---+---+   +---+   +   +---+---+---+   +
|       |   |   |           |   |   |   |   |           |               |       |   |       |   |   |
+---+   +   +   +---+---+   +---+   +   +   +---+---+   +   +---+---+---+   +---+---+   +   +   +   +
|       |   |   |       |       |   |   |           |       |       |       |           |           |
+   +---+---+   +   +   +---+   +   +   +---+---+   +---+---+---+   +   +---+   +---+---+---+---+---+
|           |       |   |           |       |                       |       |   |       |       |   |
+---+---+   +---+---+   +   +   +---+   +---+   +---+   +---+---+---+---+   +   +   +   +   +   +   +
|   |       |       |   |   |   |   |           |   |   |           |       |       |       |       |
+   +   +   +   +---+   +---+   +   +---+---+---+   +   +   +---+   +   +---+---+   +   +---+---+   +
|   |   |       |                       |           |   |   |       |   |       |   |   |           |
+   +   +---+---+   +   +---+---+---+   +   +---+---+   +   +   +   +   +   +   +---+   +   +---+---+
|   |           |   |   |           |   |               |   |   |       |   |           |           |
+   +---+---+   +   +   +   +---+   +   +   +---+---+---+   +---+---+---+   +---+---+---+---+---+   +
|           |       |       |       |   |       |       |                   |           |       |   |
+---+---+   +---+---+---+---+   +---+   +---+   +---+   +---+---+---+---+---+   +---+   +   +   +   +
|       |           |           |       |               |       |               |           |       |
+   +---+---+---+   +   +---+---+   +---+   +   +---+---+   +   +   +---+---+---+---+---+---+---+---+
|   |           |       |           |   |   |   |       |   |   |           |           |       |   |
+   +   +---+   +---+---+   +---+---+   +   +   +   +   +---+   +   +---+---+   +---+   +   +   +   +
|           |               |       |       |       |   |       |   |           |       |   |       |
+---+---+   +---+---+---+---+   +---+---+---+---+---+   +   +---+   +   +---+---+   +---+---+   +---+
|       |                   |       |   |               |           |   |       |           |       |
+   +   +---+---+---+---+   +---+   +   +   +   +---+---+---+---+---+   +   +   +---+---+   +   +   +
|   |                       |               |                           |   |                   |   0
+---+---+---+---+---+---+---+---+---+---+---+---+---+---+---+---+---+---+---+---+---+---+---+---+---+
