+---+---+---+---+---+---+---+---+---+---+---+---+---+---+---+
G           |                   |                   |       |
+---+---+   +   +---+---+---+   +   +---+---+---+   +   +   +
|   |           |           |   |   |           |       |   |
+   +   +   +---+   +---+---+   +   +   +---+   +---+---+   +
|       |   |                   |   |       |       |       |
+---+   +   +---+---+---+---+---+   +---+   +---+   +---+---+
|       |           |       |               |               |
+---+---+---+---+   +---+   +---+   +---+---+   +---+---+   +
|               |       |       |       |       |           |
+   +---+---+   +---+   +---+   +---+   +   +---+   +---+---+
|       |           |   |       |       |   |       |       |
+---+   +   +   +   +   +   +---+---+---+   +   +---+   +   +
|       |   |   |   |   |   |       |       |   |       |   |
+   +---+   +   +   +   +   +   +   +---+   +   +   +---+   +
|       |   |   |       |       |           |   |       |   |
+---+   +   +   +---+---+   +---+---+---+---+   +   +   +---+
|       |   |       |       |               |   |   |       |
+   +---+   +---+   +   +---+   +   +---+   +   +   +---+   +
|   |       |       |   |       |       |       |       |   |
+   +   +---+   +---+   +---+---+---+   +---+---+   +   +   +
|   |       |       |       |   |       |           |   |   |
+   +---+   +---+   +---+   +   +   +---+---+---+---+   +   +
|   |   |       |   |       |   |                   |   |   |
+   +   +---+   +   +   +---+   +---+   +   +---+   +   +---+
|   |       |   |       |       |       |   |       |       |
+   +---+   +   +---+---+   +---+   +---+   +   +---+---+   +
|       |       |           |       |       |   |       |   |
+---+   +---+---+   +---+   +   +---+   +---+---+   +   +   +
|       |               |       |                   |       O
+---+---+---+---+---+---+---+---+---+---+---+---+---+---+---+